date,local_outbreak,imported_cases,death,total_death,new_cases,total_cases,variation
2020-01-21,0,0,0,0,0,0,0
2020-01-22,0,0,0,0,0,0,0
2020-01-23,0,0,0,0,0,0,0
2020-01-24,0,1,0,0,1,1,1
2020-01-25,0,0,0,0,0,1,-1
2020-01-26,0,1,0,0,1,2,1
2020-01-27,0,1,0,0,1,3,0
2020-01-28,0,0,0,0,0,3,-1
2020-01-29,0,0,0,0,0,3,0
2020-01-30,1,2,0,0,3,6,3
2020-01-31,3,1,0,0,4,10,1
2020-02-01,0,1,0,0,1,11,-3
2020-02-02,1,2,0,0,3,14,2
2020-02-03,0,0,0,0,0,14,-3
2020-02-04,0,1,0,0,1,15,1
2020-02-05,3,2,0,0,5,20,4
2020-02-06,1,2,0,0,3,23,-2
2020-02-07,0,0,0,0,0,23,-3
2020-02-08,0,0,0,0,0,23,0
2020-02-09,1,2,0,0,3,26,3
2020-02-10,1,0,0,0,1,27,-2
2020-02-11,0,0,0,0,0,27,-1
2020-02-12,0,0,0,0,0,27,0
2020-02-13,0,0,0,0,0,27,0
2020-02-14,0,0,0,0,0,27,0
2020-02-15,0,0,0,0,0,27,0
2020-02-16,2,0,0,0,2,29,2
2020-02-17,0,0,0,0,0,29,-2
2020-02-18,2,0,0,0,2,31,2
2020-02-19,34,0,0,0,34,65,32
2020-02-20,16,0,1,1,16,81,-18
2020-02-21,74,0,0,1,74,155,58
2020-02-22,190,0,2,3,190,345,116
2020-02-23,209,1,0,3,210,555,20
2020-02-24,206,1,4,7,207,762,-3
2020-02-25,129,1,1,8,130,892,-77
2020-02-26,252,1,3,11,253,1145,123
2020-02-27,447,2,1,12,449,1594,196
2020-02-28,427,0,1,13,427,2021,-22
2020-02-29,909,0,3,16,909,2930,482
2020-03-01,593,2,1,17,595,3525,-314
2020-03-02,684,2,6,23,686,4211,91
2020-03-03,599,1,5,28,600,4811,-86
2020-03-04,516,0,4,32,516,5327,-84
2020-03-05,437,1,3,35,438,5765,-78
2020-03-06,518,0,7,42,518,6283,80
2020-03-07,483,0,2,44,483,6766,-35
2020-03-08,366,1,6,50,367,7133,-116
2020-03-09,247,1,1,51,248,7381,-119
2020-03-10,131,0,3,54,131,7512,-117
2020-03-11,239,3,6,60,242,7754,111
2020-03-12,112,2,6,66,114,7868,-128
2020-03-13,107,3,1,67,110,7978,-4
2020-03-14,102,5,5,72,107,8085,-3
2020-03-15,72,4,3,75,76,8161,-31
2020-03-16,70,4,0,75,74,8235,-2
2020-03-17,79,5,6,81,84,8319,10
2020-03-18,80,13,3,84,93,8412,9
2020-03-19,135,17,7,91,152,8564,59
2020-03-20,73,14,3,94,87,8651,-65
2020-03-21,126,21,8,102,147,8798,60
2020-03-22,77,21,2,104,98,8896,-49
2020-03-23,46,18,7,111,64,8960,-34
2020-03-24,46,30,9,120,76,9036,12
2020-03-25,42,58,6,126,100,9136,24
2020-03-26,56,48,5,131,104,9240,4
2020-03-27,57,34,8,139,91,9331,-13
2020-03-28,90,56,5,144,146,9477,55
2020-03-29,38,67,8,152,105,9582,-41
2020-03-30,35,43,6,158,78,9660,-27
2020-03-31,88,37,4,162,125,9785,47
2020-04-01,56,45,3,165,101,9886,-24
2020-04-02,43,46,4,169,89,9975,-12
2020-04-03,37,49,5,174,86,10061,-3
2020-04-04,53,41,3,177,94,10155,8
2020-04-05,31,50,6,183,81,10236,-13
2020-04-06,25,22,3,186,47,10283,-34
2020-04-07,23,24,6,192,47,10330,0
2020-04-08,23,30,8,200,53,10383,6
2020-04-09,13,26,4,204,39,10422,-14
2020-04-10,17,10,4,208,27,10449,-12
2020-04-11,16,14,3,211,30,10479,3
2020-04-12,9,23,3,214,32,10511,2
2020-04-13,10,15,3,217,25,10536,-7
2020-04-14,11,16,5,222,27,10563,2
2020-04-15,13,14,3,225,27,10590,0
2020-04-16,11,11,4,229,22,10612,-5
2020-04-17,7,15,1,230,22,10634,0
2020-04-18,9,9,2,232,18,10652,-4
2020-04-19,2,6,2,234,8,10660,-10
2020-04-20,6,7,2,236,13,10673,5
2020-04-21,4,5,1,237,9,10682,-4
2020-04-22,5,6,1,238,11,10693,2
2020-04-23,4,4,2,240,8,10701,-3
2020-04-24,4,2,0,240,6,10707,-2
2020-04-25,5,5,0,240,10,10717,4
2020-04-26,1,9,2,242,10,10727,0
2020-04-27,3,7,1,243,10,10737,0
2020-04-28,2,12,1,244,14,10751,4
2020-04-29,4,5,2,246,9,10760,-5
2020-04-30,0,4,1,247,4,10764,-5
2020-05-01,1,8,1,248,9,10773,5
2020-05-02,0,6,2,250,6,10779,-3
2020-05-03,3,10,0,250,13,10792,7
2020-05-04,0,8,2,252,8,10800,-5
2020-05-05,0,3,2,254,3,10803,-5
2020-05-06,0,2,1,255,2,10805,-1
2020-05-07,1,3,1,256,4,10809,2
2020-05-08,1,11,0,256,12,10821,8
2020-05-09,17,1,0,256,18,10839,6
2020-05-10,26,8,0,256,34,10873,16
2020-05-11,29,6,0,256,35,10908,1
2020-05-12,22,5,2,258,27,10935,-8
2020-05-13,22,4,1,259,26,10961,-1
2020-05-14,26,3,1,260,29,10990,3
2020-05-15,22,5,0,260,27,11017,-2
2020-05-16,9,10,2,262,19,11036,-8
2020-05-17,6,7,0,262,13,11049,-6
2020-05-18,5,10,1,263,15,11064,2
2020-05-19,9,4,0,263,13,11077,-2
2020-05-20,24,8,0,263,32,11109,19
2020-05-21,10,2,1,264,12,11121,-20
2020-05-22,11,9,0,264,20,11141,8
2020-05-23,19,4,2,266,23,11164,3
2020-05-24,17,8,0,266,25,11189,2
2020-05-25,13,3,1,267,16,11205,-9
2020-05-26,16,3,2,269,19,11224,3
2020-05-27,37,3,0,269,40,11264,21
2020-05-28,68,11,0,269,79,11343,39
2020-05-29,55,3,0,269,58,11401,-21
2020-05-30,27,12,0,269,39,11440,-19
2020-05-31,15,12,1,270,27,11467,-12
2020-06-01,30,5,1,271,35,11502,8
2020-06-02,36,2,1,272,38,11540,3
2020-06-03,46,3,1,273,49,11589,11
2020-06-04,33,6,0,273,39,11628,-10
2020-06-05,34,5,0,273,39,11667,0
2020-06-06,43,8,0,273,51,11718,12
2020-06-07,53,4,0,273,57,11775,6
2020-06-08,32,5,0,273,37,11812,-20
2020-06-09,35,3,1,274,38,11850,1
2020-06-10,43,7,2,276,50,11900,12
2020-06-11,40,5,0,276,45,11945,-5
2020-06-12,43,13,1,277,56,12001,11
2020-06-13,43,5,0,277,48,12049,-8
2020-06-14,31,3,0,277,34,12083,-14
2020-06-15,24,13,0,277,37,12120,3
2020-06-16,21,13,1,278,34,12154,-3
2020-06-17,31,12,1,279,43,12197,9
2020-06-18,51,8,1,280,59,12256,16
2020-06-19,32,17,0,280,49,12305,-10
2020-06-20,36,31,0,280,67,12372,18
2020-06-21,40,8,0,280,48,12420,-19
2020-06-22,11,6,0,280,17,12437,-31
2020-06-23,16,30,1,281,46,12483,29
2020-06-24,30,21,0,281,51,12534,5
2020-06-25,23,5,1,282,28,12562,-23
2020-06-26,26,13,0,282,39,12601,11
2020-06-27,31,20,0,282,51,12652,12
2020-06-28,40,22,0,282,62,12714,11
2020-06-29,30,12,0,282,42,12756,-20
2020-06-30,22,20,0,282,42,12798,0
2020-07-01,36,15,0,282,51,12849,9
2020-07-02,44,10,0,282,54,12903,3
2020-07-03,49,12,0,282,61,12964,7
2020-07-04,36,27,1,283,63,13027,2
2020-07-05,43,18,0,283,61,13088,-2
2020-07-06,24,24,1,284,48,13136,-13
2020-07-07,20,24,1,285,44,13180,-4
2020-07-08,30,32,0,285,62,13242,18
2020-07-09,28,22,2,287,50,13292,-12
2020-07-10,23,22,1,288,45,13337,-5
2020-07-11,20,15,0,288,35,13372,-10
2020-07-12,21,23,1,289,44,13416,9
2020-07-13,19,43,0,289,62,13478,18
2020-07-14,14,19,0,289,33,13511,-29
2020-07-15,11,28,0,289,39,13550,6
2020-07-16,14,47,2,291,61,13611,22
2020-07-17,21,39,2,293,60,13671,-1
2020-07-18,11,28,1,294,39,13710,-21
2020-07-19,21,13,1,295,34,13744,-5
2020-07-20,4,22,1,296,26,13770,-8
2020-07-21,20,25,0,296,45,13815,19
2020-07-22,29,34,1,297,63,13878,18
2020-07-23,39,20,0,297,59,13937,-4
2020-07-24,28,13,1,298,41,13978,-18
2020-07-25,27,86,0,298,113,14091,72
2020-07-26,12,46,0,298,58,14149,-55
2020-07-27,9,16,1,299,25,14174,-33
2020-07-28,5,23,1,300,28,14202,3
2020-07-29,14,34,0,300,48,14250,20
2020-07-30,7,11,0,300,18,14268,-30
2020-07-31,14,22,1,301,36,14304,18
2020-08-01,8,23,0,301,31,14335,-5
2020-08-02,8,22,0,301,30,14365,-1
2020-08-03,3,20,0,301,23,14388,-7
2020-08-04,13,21,0,301,34,14422,11
2020-08-05,13,20,1,302,33,14455,-1
2020-08-06,23,20,0,302,43,14498,10
2020-08-07,9,11,1,303,20,14518,-23
2020-08-08,30,13,1,304,43,14561,23
2020-08-09,30,6,1,305,36,14597,-7
2020-08-10,17,11,0,305,28,14625,-8
2020-08-11,23,11,0,305,34,14659,6
2020-08-12,35,19,0,305,54,14713,20
2020-08-13,47,9,0,305,56,14769,2
2020-08-14,85,18,0,305,103,14872,47
2020-08-15,154,12,0,305,166,15038,63
2020-08-16,267,12,0,305,279,15317,113
2020-08-17,188,9,0,305,197,15514,-82
2020-08-18,235,11,1,306,246,15760,49
2020-08-19,283,14,0,306,297,16057,51
2020-08-20,276,12,1,307,288,16345,-9
2020-08-21,315,9,2,309,324,16669,36
2020-08-22,315,17,0,309,332,17001,8
2020-08-23,386,10,0,309,396,17397,64
2020-08-24,258,8,0,309,266,17663,-130
2020-08-25,264,16,1,310,280,17943,14
2020-08-26,307,13,2,312,320,18263,40
2020-08-27,434,7,1,313,441,18704,121
2020-08-28,359,12,3,316,371,19075,-70
2020-08-29,308,15,5,321,323,19398,-48
2020-08-30,283,16,2,323,299,19697,-24
2020-08-31,238,10,1,324,248,19945,-51
2020-09-01,221,14,0,324,235,20180,-13
2020-09-02,253,14,2,326,267,20447,32
2020-09-03,188,7,3,329,195,20642,-72
2020-09-04,188,10,2,331,198,20840,3
2020-09-05,158,10,2,333,168,21008,-30
2020-09-06,152,15,1,334,167,21175,-1
2020-09-07,107,12,2,336,119,21294,-48
2020-09-08,120,16,5,341,136,21430,17
2020-09-09,144,12,3,344,156,21586,20
2020-09-10,140,15,2,346,155,21741,-1
2020-09-11,161,15,4,350,176,21917,21
2020-09-12,118,18,5,355,136,22053,-40
2020-09-13,99,22,3,358,121,22174,-15
2020-09-14,98,11,5,363,109,22283,-12
2020-09-15,90,16,4,367,106,22389,-3
2020-09-16,105,8,0,367,113,22502,7
2020-09-17,145,8,5,372,153,22655,40
2020-09-18,109,17,5,377,126,22781,-27
2020-09-19,106,4,1,378,110,22891,-16
2020-09-20,72,10,5,383,82,22973,-28
2020-09-21,55,15,2,385,70,23043,-12
2020-09-22,50,11,3,388,61,23104,-9
2020-09-23,99,11,0,388,110,23214,49
2020-09-24,109,16,5,393,125,23339,15
2020-09-25,95,19,2,395,114,23453,-11
2020-09-26,49,12,4,399,61,23514,-53
2020-09-27,73,22,2,401,95,23609,34
2020-09-28,40,10,5,406,50,23659,-45
2020-09-29,23,15,1,407,38,23697,-12
2020-09-30,94,19,6,413,113,23810,75
2020-10-01,67,10,2,415,77,23887,-36
2020-10-02,53,10,1,416,63,23950,-14
2020-10-03,52,23,4,420,75,24025,12
2020-10-04,47,17,1,421,64,24089,-11
2020-10-05,64,9,1,422,73,24162,9
2020-10-06,66,9,0,422,75,24237,2
2020-10-07,94,20,3,425,114,24351,39
2020-10-08,60,9,2,427,69,24420,-45
2020-10-09,38,16,1,428,54,24474,-15
2020-10-10,61,11,2,430,72,24546,18
2020-10-11,46,12,2,432,58,24604,-14
2020-10-12,69,29,1,433,98,24702,40
2020-10-13,69,22,1,434,91,24793,-7
2020-10-14,53,31,4,438,84,24877,-7
2020-10-15,95,15,1,439,110,24987,26
2020-10-16,41,6,2,441,47,25034,-63
2020-10-17,62,11,2,443,73,25107,26
2020-10-18,71,20,1,444,91,25198,18
2020-10-19,50,26,0,444,76,25274,-15
2020-10-20,41,17,3,447,58,25332,-18
2020-10-21,57,32,3,450,89,25421,31
2020-10-22,104,17,3,453,121,25542,32
2020-10-23,138,17,2,455,155,25697,34
2020-10-24,66,11,2,457,77,25774,-78
2020-10-25,50,11,0,457,61,25835,-16
2020-10-26,94,25,0,457,119,25954,58
2020-10-27,72,16,3,460,88,26042,-31
2020-10-28,96,7,1,461,103,26145,15
2020-10-29,107,18,1,462,125,26270,22
2020-10-30,93,20,1,463,113,26383,-12
2020-10-31,96,31,1,464,127,26510,14
2020-11-01,101,23,2,466,124,26634,-3
2020-11-02,79,18,2,468,97,26731,-27
2020-11-03,46,29,4,472,75,26806,-22
2020-11-04,98,19,2,474,117,26923,42
2020-11-05,108,17,1,475,125,27048,8
2020-11-06,117,28,1,476,145,27193,20
2020-11-07,72,17,1,477,89,27282,-56
2020-11-08,118,25,1,478,143,27425,54
2020-11-09,99,27,2,480,126,27551,-17
2020-11-10,71,29,5,485,100,27651,-26
2020-11-11,113,32,2,487,145,27796,45
2020-11-12,128,15,0,487,143,27939,-2
2020-11-13,162,29,1,488,191,28130,48
2020-11-14,166,39,4,492,205,28335,14
2020-11-15,176,32,1,493,208,28543,3
2020-11-16,192,30,1,494,222,28765,14
2020-11-17,202,28,0,494,230,28995,8
2020-11-18,245,40,2,496,285,29280,55
2020-11-19,293,32,2,498,325,29605,40
2020-11-20,320,28,3,501,348,29953,23
2020-11-21,361,25,2,503,386,30339,38
2020-11-22,302,28,2,505,330,30669,-56
2020-11-23,255,16,4,509,271,30940,-59
2020-11-24,318,31,1,510,349,31289,78
2020-11-25,363,19,3,513,382,31671,33
2020-11-26,552,29,2,515,581,32252,199
2020-11-27,525,30,1,516,555,32807,-26
2020-11-28,486,17,6,522,503,33310,-52
2020-11-29,413,37,1,523,450,33760,-53
2020-11-30,414,24,3,526,438,34198,-12
2020-12-01,420,31,0,526,451,34649,13
2020-12-02,492,19,0,526,511,35160,60
2020-12-03,516,24,3,529,540,35700,29
2020-12-04,600,28,7,536,628,36328,88
2020-12-05,559,18,4,540,577,36905,-51
2020-12-06,599,32,5,545,631,37536,54
2020-12-07,580,35,4,549,615,38151,-16
2020-12-08,561,26,3,552,587,38738,-28
2020-12-09,646,24,4,556,670,39408,83
2020-12-10,643,37,8,564,680,40088,10
2020-12-11,673,16,8,572,689,40777,9
2020-12-12,928,22,6,578,950,41727,261
2020-12-13,1000,30,2,580,1030,42757,80
2020-12-14,682,36,7,587,718,43475,-312
2020-12-15,848,32,13,600,880,44355,162
2020-12-16,1054,24,12,612,1078,45433,198
2020-12-17,994,20,22,634,1014,46447,-64
2020-12-18,1038,26,11,645,1064,47511,50
2020-12-19,1024,21,14,659,1045,48556,-19
2020-12-20,1071,25,15,674,1096,49652,51
2020-12-21,891,33,24,698,924,50576,-172
2020-12-22,821,45,24,722,866,51442,-58
2020-12-23,1058,32,17,739,1090,52532,224
2020-12-24,955,30,17,756,985,53517,-105
2020-12-25,1215,25,17,773,1240,54757,255
2020-12-26,1103,28,20,793,1131,55888,-109
2020-12-27,946,24,15,808,970,56858,-161
2020-12-28,786,20,11,819,806,57664,-164
2020-12-29,1028,16,40,859,1044,58708,238
2020-12-30,1025,25,20,879,1050,59758,6
2020-12-31,940,27,21,900,967,60725,-83
2021-01-01,1002,25,17,917,1027,61752,60
2021-01-02,784,36,25,942,820,62572,-207
2021-01-03,641,16,20,962,657,63229,-163
2021-01-04,986,34,19,981,1020,64249,363
2021-01-05,672,42,26,1007,714,64963,-306
2021-01-06,807,31,20,1027,838,65801,124
2021-01-07,832,37,19,1046,869,66670,31
2021-01-08,632,42,35,1081,674,67344,-195
2021-01-09,596,45,19,1100,641,67985,-33
2021-01-10,623,34,25,1125,657,68642,16
2021-01-11,419,32,15,1140,451,69093,-206
2021-01-12,510,27,25,1165,537,69630,86
2021-01-13,535,26,20,1185,561,70191,24
2021-01-14,496,28,10,1195,524,70715,-37
2021-01-15,483,29,22,1217,512,71227,-12
2021-01-16,547,33,19,1236,580,71807,68
2021-01-17,500,20,13,1249,520,72327,-60
2021-01-18,366,23,15,1264,389,72716,-131
2021-01-19,351,35,19,1283,386,73102,-3
2021-01-20,373,31,17,1300,404,73506,18
2021-01-21,381,19,16,1316,400,73906,-4
2021-01-22,314,32,12,1328,346,74252,-54
2021-01-23,403,28,9,1337,431,74683,85
2021-01-24,369,23,12,1349,392,75075,-39
2021-01-25,405,32,11,1360,437,75512,45
2021-01-26,333,16,11,1371,349,75861,-88
2021-01-27,516,43,7,1378,559,76420,210
2021-01-28,479,18,8,1386,497,76917,-62
2021-01-29,445,24,13,1399,469,77386,-28
2021-01-30,421,35,15,1414,456,77842,-13
2021-01-31,323,31,6,1420,354,78196,-102
2021-02-01,285,20,5,1425,305,78501,-49
2021-02-02,295,41,10,1435,336,78837,31
2021-02-03,433,34,6,1441,467,79304,131
2021-02-04,429,22,7,1448,451,79755,-16
2021-02-05,350,20,11,1459,370,80125,-81
2021-02-06,362,28,5,1464,390,80515,20
2021-02-07,325,46,7,1471,371,80886,-19
2021-02-08,264,24,3,1474,288,81174,-83
2021-02-09,273,30,8,1482,303,81477,15
2021-02-10,414,30,4,1486,444,81921,141
2021-02-11,467,37,10,1496,504,82425,60
2021-02-12,384,19,11,1507,403,82828,-101
2021-02-13,345,17,7,1514,362,83190,-41
2021-02-14,304,22,8,1522,326,83516,-36
2021-02-15,322,21,5,1527,343,83859,17
2021-02-16,429,28,7,1534,457,84316,114
2021-02-17,590,31,4,1538,621,84937,164
2021-02-18,590,31,6,1544,621,85558,0
2021-02-19,533,28,6,1550,561,86119,-60
2021-02-20,416,32,3,1553,448,86567,-113
2021-02-21,391,25,4,1557,416,86983,-32
2021-02-22,313,19,5,1562,332,87315,-84
2021-02-23,329,27,11,1573,356,87671,24
2021-02-24,417,23,3,1576,440,88111,84
2021-02-25,368,27,5,1581,395,88506,-45
2021-02-26,363,24,4,1585,387,88893,-8
2021-02-27,405,10,10,1595,415,89308,28
2021-02-28,333,22,8,1603,355,89663,-60
2021-03-01,338,17,2,1605,355,90018,0
2021-03-02,319,25,1,1606,344,90362,-11
2021-03-03,426,18,6,1612,444,90806,100
2021-03-04,401,23,7,1619,424,91230,-20
2021-03-05,381,17,8,1627,398,91628,-26
2021-03-06,404,14,5,1632,418,92046,20
2021-03-07,398,18,2,1634,416,92462,-2
2021-03-08,335,11,8,1642,346,92808,-70
2021-03-09,427,19,3,1645,446,93254,100
2021-03-10,452,18,3,1648,470,93724,24
2021-03-11,444,21,4,1652,465,94189,-5
2021-03-12,467,21,10,1662,488,94677,23
2021-03-13,474,16,5,1667,490,95167,2
2021-03-14,436,23,2,1669,459,95626,-31
2021-03-15,367,12,6,1675,379,96005,-80
2021-03-16,345,18,3,1678,363,96368,-16
2021-03-17,452,17,8,1686,469,96837,106
2021-03-18,427,18,2,1688,445,97282,-24
2021-03-19,441,22,2,1690,463,97745,18
2021-03-20,435,12,3,1693,447,98192,-16
2021-03-21,437,19,3,1696,456,98648,9
2021-03-22,396,19,1,1697,415,99063,-41
2021-03-23,331,15,7,1704,346,99409,-69
2021-03-24,411,17,3,1707,428,99837,82
2021-03-25,419,11,2,1709,430,100267,2
2021-03-26,466,23,7,1716,489,100756,59
2021-03-27,490,15,5,1721,505,101261,16
2021-03-28,462,20,1,1722,482,101743,-23
2021-03-29,369,13,4,1726,382,102125,-100
2021-03-30,429,18,3,1729,447,102572,65
2021-03-31,491,15,2,1731,506,103078,59
2021-04-01,537,14,4,1735,551,103629,45
2021-04-02,532,25,2,1737,557,104186,6
2021-04-03,521,22,3,1740,543,104729,-14
2021-04-04,514,29,4,1744,543,105272,0
2021-04-05,449,24,4,1748,473,105745,-70
2021-04-06,459,18,4,1752,477,106222,4
2021-04-07,653,15,4,1756,668,106890,191
2021-04-08,674,26,2,1758,700,107590,32
2021-04-09,644,27,6,1764,671,108261,-29
2021-04-10,662,15,1,1765,677,108938,6
2021-04-11,594,20,3,1768,614,109552,-63
2021-04-12,560,27,2,1770,587,110139,-27
2021-04-13,528,14,5,1775,542,110681,-45
2021-04-14,714,17,7,1782,731,111412,189
2021-04-15,670,28,6,1788,698,112110,-33
2021-04-16,652,21,2,1790,673,112783,-25
2021-04-17,630,28,4,1794,658,113441,-15
2021-04-18,648,23,3,1797,671,114112,13
2021-04-19,512,20,4,1801,532,114644,-139
2021-04-20,529,20,1,1802,549,115193,17
2021-04-21,692,39,4,1806,731,115924,182
2021-04-22,715,20,2,1808,735,116659,4
2021-04-23,758,39,3,1811,797,117456,62
2021-04-24,759,26,1,1812,785,118241,-12
2021-04-25,603,41,1,1813,644,118885,-141
2021-04-26,469,30,4,1817,499,119384,-145
2021-04-27,477,35,3,1820,512,119896,13
2021-04-28,748,21,1,1821,769,120665,257
2021-04-29,648,31,4,1825,679,121344,-90
2021-04-30,642,19,3,1828,661,122005,-18
2021-05-01,593,34,3,1831,627,122632,-34
2021-05-02,585,21,2,1833,606,123238,-21
2021-05-03,465,23,1,1834,488,123726,-118
2021-05-04,514,27,6,1840,541,124267,53
2021-05-05,650,26,7,1847,676,124943,135
2021-05-06,562,12,4,1851,574,125517,-102
2021-05-07,509,16,9,1860,525,126042,-49
2021-05-08,672,29,5,1865,701,126743,176
2021-05-09,522,42,9,1874,564,127307,-137
2021-05-10,436,27,1,1875,463,127770,-101
2021-05-11,483,27,4,1879,510,128280,47
2021-05-12,612,22,5,1884,634,128914,124
2021-05-13,692,23,7,1891,715,129629,81
2021-05-14,729,18,2,1893,747,130376,32
2021-05-15,661,20,3,1896,681,131057,-66
2021-05-16,572,38,4,1900,610,131667,-71
2021-05-17,597,22,3,1903,619,132286,9
2021-05-18,506,22,1,1904,528,132814,-91
2021-05-19,637,17,8,1912,654,133468,126
2021-05-20,619,27,4,1916,646,134114,-8
2021-05-21,542,19,6,1922,561,134675,-85
2021-05-22,633,33,4,1926,666,135341,105
2021-05-23,570,15,5,1931,585,135926,-81
2021-05-24,505,25,3,1934,530,136456,-55
2021-05-25,481,35,4,1938,516,136972,-14
2021-05-26,684,21,2,1940,705,137677,189
2021-05-27,620,9,3,1943,629,138306,-76
2021-05-28,571,16,3,1946,587,138893,-42
2021-05-29,505,28,5,1951,533,139426,-54
2021-05-30,464,16,6,1957,480,139906,-53
2021-05-31,411,19,2,1959,430,140336,-50
2021-06-01,449,10,4,1963,459,140795,29
2021-06-02,654,23,2,1965,677,141472,218
2021-06-03,672,9,3,1968,681,142153,4
2021-06-04,674,21,1,1969,695,142848,14
2021-06-05,725,19,2,1971,744,143592,49
2021-06-06,541,15,2,1973,556,144148,-188
2021-06-07,454,31,1,1974,485,144633,-71
2021-06-08,435,19,1,1975,454,145087,-31
2021-06-09,581,21,2,1977,602,145689,148
2021-06-10,593,17,2,1979,610,146299,8
2021-06-11,541,15,2,1981,556,146855,-54
2021-06-12,525,40,1,1982,565,147420,9
2021-06-13,419,33,3,1985,452,147872,-113
2021-06-14,360,39,3,1988,399,148271,-53
2021-06-15,347,26,4,1992,373,148644,-26
2021-06-16,522,23,1,1993,545,149189,172
2021-06-17,523,17,1,1994,540,149729,-5
2021-06-18,485,22,2,1996,507,150236,-33
2021-06-19,456,26,1,1997,482,150718,-25
2021-06-20,380,49,5,2002,429,151147,-53
2021-06-21,317,40,2,2004,357,151504,-72
2021-06-22,350,44,2,2006,394,151898,37
2021-06-23,605,40,1,2007,645,152543,251
2021-06-24,576,34,1,2008,610,153153,-35
2021-06-25,602,32,1,2009,634,153787,24
2021-06-26,611,57,3,2012,668,154455,34
2021-06-27,570,44,1,2013,614,155069,-54
2021-06-28,472,29,2,2015,501,155570,-113
2021-06-29,560,35,2,2017,595,156165,94
2021-06-30,759,35,1,2018,794,156959,199
2021-07-01,711,50,3,2021,761,157720,-33
2021-07-02,765,60,3,2024,825,158545,64
2021-07-03,748,46,1,2025,794,159339,-31
2021-07-04,662,81,1,2026,743,160082,-51
2021-07-05,644,67,2,2028,711,160793,-32
2021-07-06,690,56,4,2032,746,161539,35
2021-07-07,1166,45,1,2033,1211,162750,465
2021-07-08,1227,48,1,2034,1275,164025,64
2021-07-09,1236,80,2,2036,1316,165341,41
2021-07-10,1320,58,2,2038,1378,166719,62
2021-07-11,1280,44,5,2043,1324,168043,-54
2021-07-12,1063,37,1,2044,1100,169143,-224
2021-07-13,1097,53,2,2046,1150,170293,50
2021-07-14,1566,47,2,2048,1613,171906,463
2021-07-15,1554,45,2,2050,1599,173505,-14
2021-07-16,1475,60,1,2051,1535,175040,-64
2021-07-17,1400,49,4,2055,1449,176489,-86
2021-07-18,1402,51,2,2057,1453,177942,4
2021-07-19,1207,44,1,2058,1251,179193,-202
2021-07-20,1242,36,1,2059,1278,180471,27
2021-07-21,1725,56,1,2060,1781,182252,503
2021-07-22,1532,309,3,2063,1841,184093,60
2021-07-23,1573,56,3,2066,1629,185722,-212
2021-07-24,1572,55,2,2068,1627,187349,-2
2021-07-25,1422,65,5,2073,1487,188836,-140
2021-07-26,1264,54,4,2077,1318,190154,-169
2021-07-27,1274,89,2,2079,1363,191517,45
2021-07-28,1822,73,4,2083,1895,193412,532
2021-07-29,1631,42,2,2085,1673,195085,-222
2021-07-30,1662,48,4,2089,1710,196795,37
2021-07-31,1465,73,6,2095,1538,198333,-172
2021-08-01,1386,56,3,2098,1442,199775,-96
2021-08-02,1150,68,1,2099,1218,200993,-224
2021-08-03,1150,50,5,2104,1200,202193,-18
2021-08-04,1664,61,2,2106,1725,203918,525
2021-08-05,1716,59,3,2109,1775,205693,50
2021-08-06,1640,64,4,2113,1704,207397,-71
2021-08-07,1762,61,3,2116,1823,209220,119
2021-08-08,1668,59,5,2121,1727,210947,-96
2021-08-09,1455,36,4,2125,1491,212438,-236
2021-08-10,1474,63,9,2134,1537,213975,46
2021-08-11,2144,77,1,2135,2221,216196,684
2021-08-12,1947,40,3,2138,1987,218183,-234
2021-08-13,1913,76,6,2144,1989,220172,2
2021-08-14,1858,70,4,2148,1928,222100,-61
2021-08-15,1748,68,8,2156,1816,223916,-112
2021-08-16,1491,63,11,2167,1554,225470,-262
2021-08-17,1322,50,6,2173,1372,226842,-182
2021-08-18,1766,37,5,2178,1803,228645,431
2021-08-19,2114,38,13,2191,2152,230797,349
2021-08-20,2000,50,6,2197,2050,232847,-102
2021-08-21,1811,65,5,2202,1876,234723,-174
2021-08-22,1588,38,13,2215,1626,236349,-250
2021-08-23,1370,47,7,2222,1417,237766,-209
2021-08-24,1469,38,6,2228,1507,239273,90
2021-08-25,2113,41,9,2237,2154,241427,647
2021-08-26,1829,53,20,2257,1882,243309,-272
2021-08-27,1809,28,8,2265,1837,245146,-45
2021-08-28,1736,55,11,2276,1791,246937,-46
2021-08-29,1576,43,3,2279,1619,248556,-172
2021-08-30,1424,61,5,2284,1485,250041,-134
2021-08-31,1331,38,1,2285,1369,251410,-116
2021-09-01,1991,33,7,2292,2024,253434,655
2021-09-02,1926,34,11,2303,1960,255394,-64
2021-09-03,1674,34,5,2308,1708,257102,-252
2021-09-04,1775,28,7,2315,1803,258905,95
2021-09-05,1461,29,6,2321,1490,260395,-313
2021-09-06,1351,24,6,2327,1375,261770,-115
2021-09-07,1563,34,3,2330,1597,263367,222
2021-09-08,2012,36,4,2334,2048,265415,451
2021-09-09,2018,31,9,2343,2049,267464,1
2021-09-10,1857,35,5,2348,1892,269356,-157
2021-09-11,1815,49,10,2358,1864,271220,-28
2021-09-12,1725,30,1,2359,1755,272975,-109
2021-09-13,1409,24,1,2360,1433,274408,-322
2021-09-14,1461,34,7,2367,1495,275903,62
2021-09-15,2055,23,13,2380,2078,277981,583
2021-09-16,1920,22,6,2386,1942,279923,-136
2021-09-17,1973,35,3,2389,2008,281931,66
2021-09-18,2047,40,5,2394,2087,284018,79
2021-09-19,1870,39,10,2404,1909,285927,-178
2021-09-20,1576,28,5,2409,1604,287531,-305
2021-09-21,1697,32,4,2413,1729,289260,125
2021-09-22,1703,17,6,2419,1720,290980,-9
2021-09-23,1697,18,8,2427,1715,292695,-5
2021-09-24,2411,18,7,2434,2429,295124,714
2021-09-25,3242,28,7,2441,3270,298394,841
2021-09-26,2734,34,9,2450,2768,301162,-502
2021-09-27,2354,27,6,2456,2381,303543,-387
2021-09-28,2269,19,8,2464,2288,305831,-93
2021-09-29,2855,26,10,2474,2881,308712,593
2021-09-30,2536,25,7,2481,2561,311273,-320
2021-10-01,2449,34,16,2497,2483,313756,-78
2021-10-02,2220,27,7,2504,2247,316003,-236
2021-10-03,2057,28,3,2507,2085,318088,-162
2021-10-04,1650,20,6,2513,1670,319758,-415
2021-10-05,1555,19,11,2524,1574,321332,-96
2021-10-06,2001,26,12,2536,2027,323359,453
2021-10-07,2398,27,8,2544,2425,325784,398
2021-10-08,2140,31,10,2554,2171,327955,-254
2021-10-09,1924,29,6,2560,1953,329908,-218
2021-10-10,1560,34,15,2575,1594,331502,-359
2021-10-11,1284,13,8,2583,1297,332799,-297
2021-10-12,1333,13,11,2594,1346,334145,49
2021-10-13,1570,13,11,2605,1583,335728,237
2021-10-14,1924,15,13,2618,1939,337667,356
2021-10-15,1669,14,8,2626,1683,339350,-256
2021-10-16,1593,24,18,2644,1617,340967,-66
2021-10-17,1403,17,16,2660,1420,342387,-197
2021-10-18,1030,20,8,2668,1050,343437,-370
2021-10-19,1048,25,21,2689,1073,344510,23
2021-10-20,1556,15,9,2698,1571,346081,498
2021-10-21,1430,11,11,2709,1441,347522,-130
2021-10-22,1418,20,16,2725,1438,348960,-3
2021-10-23,1487,21,20,2745,1508,350468,70
2021-10-24,1394,28,21,2766,1422,351890,-86
2021-10-25,1167,23,7,2773,1190,353080,-232
2021-10-26,1245,20,15,2788,1265,354345,75
2021-10-27,1931,21,9,2797,1952,356297,687
2021-10-28,2094,16,11,2808,2110,358407,158
2021-10-29,2094,30,9,2817,2124,360531,14
2021-10-30,2089,15,13,2830,2104,362635,-20
2021-10-31,2052,9,19,2849,2061,364696,-43
2021-11-01,1665,20,9,2858,1685,366381,-376
2021-11-02,1578,11,16,2874,1589,367970,-96
2021-11-03,2640,27,18,2892,2667,370637,1078
2021-11-04,2457,25,24,2916,2482,373119,-185
2021-11-05,2323,20,20,2936,2343,375462,-139
2021-11-06,2218,29,20,2956,2247,377709,-96
2021-11-07,2204,20,11,2967,2224,379933,-23
2021-11-08,1733,27,13,2980,1760,381693,-464
